abakan => Абакан
azov => Азов
aleksandrov => Александров
aleksin => Алексин
almetevsk => Альметьевск
anapa => Анапа
angarsk => Ангарск
anzhero-sudzhensk => Анжеро-Судженск
apatity => Апатиты
arzamas => Арзамас
armavir => Армавир
arsenev => Арсеньев
artem => Артем
arhangelsk => Архангельск
asbest => Асбест
astrahan => Астрахань
achinsk => Ачинск
balakovo => Балаково
balahna => Балахна
balashiha => Балашиха
balashov => Балашов
barnaul => Барнаул
bataysk => Батайск
belgorod => Белгород
belebey => Белебей
belovo => Белово
belogorsk-amurskaya-oblast => Белогорск (Амурская область)
beloretsk => Белорецк
belorechensk => Белореченск
berdsk => Бердск
berezniki => Березники
berezovskiy-sverdlovskaya-oblast => Березовский (Свердловская область)
biysk => Бийск
birobidzhan => Биробиджан
blagoveschensk-amurskaya-oblast => Благовещенск (Амурская область)
bor => Бор
borisoglebsk => Борисоглебск
borovichi => Боровичи
bratsk => Братск
bryansk => Брянск
bugulma => Бугульма
budennovsk => Буденновск
buzuluk => Бузулук
buynaksk => Буйнакск
velikie-luki => Великие Луки
velikiy-novgorod => Великий Новгород
verhnyaya-pyshma => Верхняя Пышма
vidnoe => Видное
vladivostok => Владивосток
vladikavkaz => Владикавказ
vladimir => Владимир
volgograd => Волгоград
volgodonsk => Волгодонск
volzhsk => Волжск
volzhskiy => Волжский
vologda => Вологда
volsk => Вольск
vorkuta => Воркута
voronezh => Воронеж
voskresensk => Воскресенск
votkinsk => Воткинск
vsevolozhsk => Всеволожск
vyborg => Выборг
vyksa => Выкса
vyazma => Вязьма
gatchina => Гатчина
gelendzhik => Геленджик
georgievsk => Георгиевск
glazov => Глазов
gorno-altaysk => Горно-Алтайск
groznyy => Грозный
gubkin => Губкин
gudermes => Гудермес
gukovo => Гуково
gus-hrustalnyy => Гусь-Хрустальный
derbent => Дербент
dzerzhinsk => Дзержинск
dimitrovgrad => Димитровград
dmitrov => Дмитров
dolgoprudnyy => Долгопрудный
domodedovo => Домодедово
donskoy => Донской
dubna => Дубна
evpatoriya => Евпатория
egorevsk => Егорьевск
eysk => Ейск
ekaterinburg => Екатеринбург
elabuga => Елабуга
elets => Елец
essentuki => Ессентуки
zheleznogorsk-krasnoyarskiy-kray => Железногорск (Красноярский край)
zheleznogorsk-kurskaya-oblast => Железногорск (Курская область)
zhigulevsk => Жигулевск
zhukovskiy => Жуковский
zarechnyy => Заречный
zelenogorsk => Зеленогорск
zelenodolsk => Зеленодольск
zlatoust => Златоуст
ivanovo => Иваново
ivanteevka => Ивантеевка
izhevsk => Ижевск
izberbash => Избербаш
irkutsk => Иркутск
iskitim => Искитим
ishim => Ишим
ishimbay => Ишимбай
yoshkar-ola => Йошкар-Ола
kazan => Казань
kaliningrad => Калининград
kaluga => Калуга
kamensk-uralskiy => Каменск-Уральский
kamensk-shahtinskiy => Каменск-Шахтинский
kamyshin => Камышин
kansk => Канск
kaspiysk => Каспийск
kemerovo => Кемерово
kerch => Керчь
kineshma => Кинешма
kirishi => Кириши
kirov-kirovskaya-oblast => Киров (Кировская область)
kirovo-chepetsk => Кирово-Чепецк
kiselevsk => Киселевск
kislovodsk => Кисловодск
klin => Клин
klintsy => Клинцы
kovrov => Ковров
kogalym => Когалым
kolomna => Коломна
komsomolsk-na-amure => Комсомольск-на-Амуре
kopeysk => Копейск
korolev => Королев
kostroma => Кострома
kotlas => Котлас
krasnogorsk => Красногорск
krasnodar => Краснодар
krasnokamensk => Краснокаменск
krasnokamsk => Краснокамск
krasnoturinsk => Краснотурьинск
krasnoyarsk => Красноярск
kropotkin => Кропоткин
krymsk => Крымск
kstovo => Кстово
kuznetsk => Кузнецк
kumertau => Кумертау
kungur => Кунгур
kurgan => Курган
kursk => Курск
kyzyl => Кызыл
labinsk => Лабинск
leninogorsk => Лениногорск
leninsk-kuznetskiy => Ленинск-Кузнецкий
lesosibirsk => Лесосибирск
lipetsk => Липецк
liski => Лиски
lobnya => Лобня
lysva => Лысьва
lytkarino => Лыткарино
lyubertsy => Люберцы
magadan => Магадан
magnitogorsk => Магнитогорск
maykop => Майкоп
mahachkala => Махачкала
mezhdurechensk => Междуреченск
meleuz => Мелеуз
miass => Миасс
mineralnye-vody => Минеральные Воды
minusinsk => Минусинск
mihaylovka => Михайловка
mihaylovsk-stavropolskiy-kray => Михайловск (Ставропольский край)
michurinsk => Мичуринск
 ?>">Москва</a></div>
murmansk => Мурманск
murom => Муром
mytischi => Мытищи
naberezhnye-chelny => Набережные Челны
nazarovo => Назарово
nazran => Назрань
nalchik => Нальчик
naro-fominsk => Наро-Фоминск
nahodka => Находка
nevinnomyssk => Невинномысск
neryungri => Нерюнгри
neftekamsk => Нефтекамск
nefteyugansk => Нефтеюганск
nizhnevartovsk => Нижневартовск
nizhnekamsk => Нижнекамск
nizhniy-novgorod => Нижний Новгород
nizhniy-tagil => Нижний Тагил
novoaltaysk => Новоалтайск
novokuznetsk => Новокузнецк
novokuybyshevsk => Новокуйбышевск
novomoskovsk => Новомосковск
novorossiysk => Новороссийск
novosibirsk => Новосибирск
novotroitsk => Новотроицк
novouralsk => Новоуральск
novocheboksarsk => Новочебоксарск
novocherkassk => Новочеркасск
novoshahtinsk => Новошахтинск
novyy-urengoy => Новый Уренгой
noginsk => Ногинск
norilsk => Норильск
noyabrsk => Ноябрьск
nyagan => Нягань
obninsk => Обнинск
odintsovo => Одинцово
ozersk-chelyabinskaya-oblast => Озерск (Челябинская область)
oktyabrskiy => Октябрьский
omsk => Омск
orel => Орел
orenburg => Оренбург
orekhovo-zuevo => Орехово-Зуево
orsk => Орск
pavlovo => Павлово
pavlovskiy-posad => Павловский Посад
penza => Пенза
pervouralsk => Первоуральск
perm => Пермь
petrozavodsk => Петрозаводск
petropavlovsk-kamchatskiy => Петропавловск-Камчатский
podolsk => Подольск
polevskoy => Полевской
prokopevsk => Прокопьевск
prohladnyy => Прохладный
pskov => Псков
pushkino => Пушкино
pyatigorsk => Пятигорск
ramenskoe => Раменское
revda => Ревда
reutov => Реутов
rzhev => Ржев
roslavl => Рославль
rossosh => Россошь
rostov-na-donu => Ростов-на-Дону
rubtsovsk => Рубцовск
rybinsk => Рыбинск
ryazan => Рязань
salavat => Салават
salsk => Сальск
samara => Самара
sankt-peterburg => Санкт-Петербург
saransk => Саранск
sarapul => Сарапул
saratov => Саратов
sarov => Саров
svobodnyy => Свободный
sevastopol => Севастополь
severodvinsk => Северодвинск
seversk => Северск
sergiev-posad => Сергиев Посад
serov => Серов
serpuhov => Серпухов
sertolovo => Сертолово
sibay => Сибай
simferopol => Симферополь
slavyansk-na-kubani => Славянск-на-Кубани
smolensk => Смоленск
solikamsk => Соликамск
solnechnogorsk => Солнечногорск
sosnovyy-bor => Сосновый Бор
sochi => Сочи
stavropol => Ставрополь
staryy-oskol => Старый Оскол
sterlitamak => Стерлитамак
stupino => Ступино
surgut => Сургут
syzran => Сызрань
syktyvkar => Сыктывкар
taganrog => Таганрог
tambov => Тамбов
tver => Тверь
timashevsk => Тимашевск
tihvin => Тихвин
tihoretsk => Тихорецк
tobolsk => Тобольск
tolyatti => Тольятти
tomsk => Томск
troitsk => Троицк
tuapse => Туапсе
tuymazy => Туймазы
tula => Тула
tyumen => Тюмень
uzlovaya => Узловая
ulan-ude => Улан-Удэ
ulyanovsk => Ульяновск
urus-martan => Урус-Мартан
usole-sibirskoe => Усолье-Сибирское
ussuriysk => Уссурийск
ust-ilimsk => Усть-Илимск
ufa => Уфа
uhta => Ухта
feodosiya => Феодосия
fryazino => Фрязино
habarovsk => Хабаровск
hanty-mansiysk => Ханты-Мансийск
hasavyurt => Хасавюрт
himki => Химки
chaykovskiy => Чайковский
chapaevsk => Чапаевск
cheboksary => Чебоксары
chelyabinsk => Челябинск
cheremhovo => Черемхово
cherepovets => Череповец
cherkessk => Черкесск
chernogorsk => Черногорск
chekhov => Чехов
chistopol => Чистополь
chita => Чита
shadrinsk => Шадринск
shali => Шали
shahty => Шахты
shuya => Шуя
schekino => Щекино
schelkovo => Щелково
elektrostal => Электросталь
elista => Элиста
engels => Энгельс
yuzhno-sahalinsk => Южно-Сахалинск
yurga => Юрга
yakutsk => Якутск
yalta => Ялта
yaroslavl => Ярославль